 .#..#..###
####.###.#
....###.#.
..###.##.#
##.##.#.#.
....###..#
..#.#..#.#
#..#.#.###
.##...##.#
.....#.#..