.#....#####...#..
##...##.#####..##
##...#...#.#####.
..#.....#...###..
..#.#.....#....##
.................
.................
.................
.................
.................
.................
.................
.................
.................
.................
.................
.................